AC	A	Integer	Alternate allele count for samples
AN	1	Integer	Total number of alleles in samples
AF	A	Float	Alternate allele frequency in samples
rf_tp_probability	1	Float	Random forest prediction probability for a site being a true variant
FS	1	Float	Phred-scaled p-value of Fisher's exact test for strand bias
InbreedingCoeff	1	Float	Inbreeding coefficient as estimated from the genotype likelihoods per-sample when compared against the Hardy-Weinberg expectation
MQ	1	Float	Root mean square of the mapping quality of reads across all samples
MQRankSum	1	Float	Z-score from Wilcoxon rank sum test of alternate vs. reference read mapping qualities
QD	1	Float	Variant call confidence normalized by depth of sample reads supporting a variant
ReadPosRankSum	1	Float	Z-score from Wilcoxon rank sum test of alternate vs. reference read position bias
SOR	1	Float	Strand bias estimated by the symmetric odds ratio test
VQSR_POSITIVE_TRAIN_SITE	0	Flag	Variant was used to build the positive training set of high-quality variants for VQSR
VQSR_NEGATIVE_TRAIN_SITE	0	Flag	Variant was used to build the negative training set of low-quality variants for VQSR
BaseQRankSum	1	Float	Z-score from Wilcoxon rank sum test of alternate vs. reference base qualities
ClippingRankSum	1	Float	Z-score from Wilcoxon rank sum test of alternate vs. reference number of hard clipped bases
DP	1	Integer	Depth of informative coverage for each sample; reads with MQ=255 or with bad mates are filtered
VQSLOD	1	Float	Log-odds ratio of being a true variant versus being a false positive under the trained VQSR Gaussian mixture model
VQSR_culprit	1	String	Worst-performing annotation in the VQSR Gaussian mixture model
segdup	0	Flag	Variant falls within a segmental duplication region
lcr	0	Flag	Variant falls within a low complexity region
decoy	0	Flag	Variant falls within a reference decoy region
nonpar	0	Flag	Variant (on sex chromosome) falls outside a pseudoautosomal region
rf_positive_label	0	Flag	Variant was labelled as a positive example for training of random forest model
rf_negative_label	0	Flag	Variant was labelled as a negative example for training of random forest model
rf_label	1	String	Random forest training label
rf_train	0	Flag	Variant was used in training random forest model
transmitted_singleton	0	Flag	Variant was a callset-wide doubleton that was transmitted within a family (i.e., a singleton amongst unrelated sampes in cohort)
variant_type	1	String	Variant type (snv, indel, multi-snv, multi-indel, or mixed)
allele_type	A	String	Allele type (snv, ins, del, or mixed)
n_alt_alleles	A	Integer	Total number of alternate alleles observed at variant locus
was_mixed	0	Flag	Variant type was mixed
has_star	0	Flag	Variant locus coincides with a spanning deletion (represented by a star) observed elsewhere in the callset
pab_max	A	Float	Maximum p-value over callset for binomial test of observed allele balance for a heterozygous genotype, given expectation of AB=0.5
gq_hist_alt_bin_freq	A	String	Histogram for GQ in heterozygous individuals; bin edges are: 0|5|10|15|20|25|30|35|40|45|50|55|60|65|70|75|80|85|90|95|100
gq_hist_all_bin_freq	A	String	Histogram for GQ; bin edges are: 0|5|10|15|20|25|30|35|40|45|50|55|60|65|70|75|80|85|90|95|100
dp_hist_alt_bin_freq	A	String	Histogram for DP in heterozygous individuals; bin edges are: 0|5|10|15|20|25|30|35|40|45|50|55|60|65|70|75|80|85|90|95|100
dp_hist_alt_n_larger	A	Integer	Count of DP values falling above highest histogram bin edge
dp_hist_all_bin_freq	A	String	Histogram for DP; bin edges are: 0|5|10|15|20|25|30|35|40|45|50|55|60|65|70|75|80|85|90|95|100
dp_hist_all_n_larger	A	Integer	Count of DP values falling above highest histogram bin edge
ab_hist_alt_bin_freq	A	String	Histogram for AB in heterozygous individuals; bin edges are: 0.00|0.05|0.10|0.15|0.20|0.25|0.30|0.35|0.40|0.45|0.50|0.55|0.60|0.65|0.70|0.75|0.80|0.85|0.90|0.95|1.00
AC_nfe_seu	A	Integer	Alternate allele count for samples of Southern European ancestry
AN_nfe_seu	1	Integer	Total number of alleles in samples of Southern European ancestry
AF_nfe_seu	A	Float	Alternate allele frequency in samples of Southern European ancestry
nhomalt_nfe_seu	A	Integer	Count of homozygous individuals in samples of Southern European ancestry
controls_AC_afr_male	A	Integer	Alternate allele count for male samples of African-American/African ancestry in the controls subset
controls_AN_afr_male	1	Integer	Total number of alleles in male samples of African-American/African ancestry in the controls subset
controls_AF_afr_male	A	Float	Alternate allele frequency in male samples of African-American/African ancestry in the controls subset
controls_nhomalt_afr_male	A	Integer	Count of homozygous individuals in male samples of African-American/African ancestry in the controls subset
non_topmed_AC_amr	A	Integer	Alternate allele count for samples of Latino ancestry in the non_topmed subset
non_topmed_AN_amr	1	Integer	Total number of alleles in samples of Latino ancestry in the non_topmed subset
non_topmed_AF_amr	A	Float	Alternate allele frequency in samples of Latino ancestry in the non_topmed subset
non_topmed_nhomalt_amr	A	Integer	Count of homozygous individuals in samples of Latino ancestry in the non_topmed subset
AC_raw	A	Integer	Alternate allele count for samples, before removing low-confidence genotypes
AN_raw	1	Integer	Total number of alleles in samples, before removing low-confidence genotypes
AF_raw	A	Float	Alternate allele frequency in samples, before removing low-confidence genotypes
nhomalt_raw	A	Integer	Count of homozygous individuals in samples, before removing low-confidence genotypes
AC_fin_female	A	Integer	Alternate allele count for female samples of Finnish ancestry
AN_fin_female	1	Integer	Total number of alleles in female samples of Finnish ancestry
AF_fin_female	A	Float	Alternate allele frequency in female samples of Finnish ancestry
nhomalt_fin_female	A	Integer	Count of homozygous individuals in female samples of Finnish ancestry
non_neuro_AC_asj_female	A	Integer	Alternate allele count for female samples of Ashkenazi Jewish ancestry in the non_neuro subset
non_neuro_AN_asj_female	1	Integer	Total number of alleles in female samples of Ashkenazi Jewish ancestry in the non_neuro subset
non_neuro_AF_asj_female	A	Float	Alternate allele frequency in female samples of Ashkenazi Jewish ancestry in the non_neuro subset
non_neuro_nhomalt_asj_female	A	Integer	Count of homozygous individuals in female samples of Ashkenazi Jewish ancestry in the non_neuro subset
non_neuro_AC_afr_male	A	Integer	Alternate allele count for male samples of African-American/African ancestry in the non_neuro subset
non_neuro_AN_afr_male	1	Integer	Total number of alleles in male samples of African-American/African ancestry in the non_neuro subset
non_neuro_AF_afr_male	A	Float	Alternate allele frequency in male samples of African-American/African ancestry in the non_neuro subset
non_neuro_nhomalt_afr_male	A	Integer	Count of homozygous individuals in male samples of African-American/African ancestry in the non_neuro subset
AC_afr_male	A	Integer	Alternate allele count for male samples of African-American/African ancestry
AN_afr_male	1	Integer	Total number of alleles in male samples of African-American/African ancestry
AF_afr_male	A	Float	Alternate allele frequency in male samples of African-American/African ancestry
nhomalt_afr_male	A	Integer	Count of homozygous individuals in male samples of African-American/African ancestry
AC_afr	A	Integer	Alternate allele count for samples of African-American/African ancestry
AN_afr	1	Integer	Total number of alleles in samples of African-American/African ancestry
AF_afr	A	Float	Alternate allele frequency in samples of African-American/African ancestry
nhomalt_afr	A	Integer	Count of homozygous individuals in samples of African-American/African ancestry
non_neuro_AC_afr_female	A	Integer	Alternate allele count for female samples of African-American/African ancestry in the non_neuro subset
non_neuro_AN_afr_female	1	Integer	Total number of alleles in female samples of African-American/African ancestry in the non_neuro subset
non_neuro_AF_afr_female	A	Float	Alternate allele frequency in female samples of African-American/African ancestry in the non_neuro subset
non_neuro_nhomalt_afr_female	A	Integer	Count of homozygous individuals in female samples of African-American/African ancestry in the non_neuro subset
non_topmed_AC_amr_female	A	Integer	Alternate allele count for female samples of Latino ancestry in the non_topmed subset
non_topmed_AN_amr_female	1	Integer	Total number of alleles in female samples of Latino ancestry in the non_topmed subset
non_topmed_AF_amr_female	A	Float	Alternate allele frequency in female samples of Latino ancestry in the non_topmed subset
non_topmed_nhomalt_amr_female	A	Integer	Count of homozygous individuals in female samples of Latino ancestry in the non_topmed subset
non_topmed_AC_oth_female	A	Integer	Alternate allele count for female samples of Other ancestry in the non_topmed subset
non_topmed_AN_oth_female	1	Integer	Total number of alleles in female samples of Other ancestry in the non_topmed subset
non_topmed_AF_oth_female	A	Float	Alternate allele frequency in female samples of Other ancestry in the non_topmed subset
non_topmed_nhomalt_oth_female	A	Integer	Count of homozygous individuals in female samples of Other ancestry in the non_topmed subset
AC_eas_female	A	Integer	Alternate allele count for female samples of East Asian ancestry
AN_eas_female	1	Integer	Total number of alleles in female samples of East Asian ancestry
AF_eas_female	A	Float	Alternate allele frequency in female samples of East Asian ancestry
nhomalt_eas_female	A	Integer	Count of homozygous individuals in female samples of East Asian ancestry
AC_afr_female	A	Integer	Alternate allele count for female samples of African-American/African ancestry
AN_afr_female	1	Integer	Total number of alleles in female samples of African-American/African ancestry
AF_afr_female	A	Float	Alternate allele frequency in female samples of African-American/African ancestry
nhomalt_afr_female	A	Integer	Count of homozygous individuals in female samples of African-American/African ancestry
non_neuro_AC_female	A	Integer	Alternate allele count for female samples in the non_neuro subset
non_neuro_AN_female	1	Integer	Total number of alleles in female samples in the non_neuro subset
non_neuro_AF_female	A	Float	Alternate allele frequency in female samples in the non_neuro subset
non_neuro_nhomalt_female	A	Integer	Count of homozygous individuals in female samples in the non_neuro subset
controls_AC_afr	A	Integer	Alternate allele count for samples of African-American/African ancestry in the controls subset
controls_AN_afr	1	Integer	Total number of alleles in samples of African-American/African ancestry in the controls subset
controls_AF_afr	A	Float	Alternate allele frequency in samples of African-American/African ancestry in the controls subset
controls_nhomalt_afr	A	Integer	Count of homozygous individuals in samples of African-American/African ancestry in the controls subset
AC_nfe_onf	A	Integer	Alternate allele count for samples of Other Non-Finnish European ancestry
AN_nfe_onf	1	Integer	Total number of alleles in samples of Other Non-Finnish European ancestry
AF_nfe_onf	A	Float	Alternate allele frequency in samples of Other Non-Finnish European ancestry
nhomalt_nfe_onf	A	Integer	Count of homozygous individuals in samples of Other Non-Finnish European ancestry
controls_AC_fin_male	A	Integer	Alternate allele count for male samples of Finnish ancestry in the controls subset
controls_AN_fin_male	1	Integer	Total number of alleles in male samples of Finnish ancestry in the controls subset
controls_AF_fin_male	A	Float	Alternate allele frequency in male samples of Finnish ancestry in the controls subset
controls_nhomalt_fin_male	A	Integer	Count of homozygous individuals in male samples of Finnish ancestry in the controls subset
non_neuro_AC_nfe_nwe	A	Integer	Alternate allele count for samples of North-Western European ancestry in the non_neuro subset
non_neuro_AN_nfe_nwe	1	Integer	Total number of alleles in samples of North-Western European ancestry in the non_neuro subset
non_neuro_AF_nfe_nwe	A	Float	Alternate allele frequency in samples of North-Western European ancestry in the non_neuro subset
non_neuro_nhomalt_nfe_nwe	A	Integer	Count of homozygous individuals in samples of North-Western European ancestry in the non_neuro subset
AC_fin_male	A	Integer	Alternate allele count for male samples of Finnish ancestry
AN_fin_male	1	Integer	Total number of alleles in male samples of Finnish ancestry
AF_fin_male	A	Float	Alternate allele frequency in male samples of Finnish ancestry
nhomalt_fin_male	A	Integer	Count of homozygous individuals in male samples of Finnish ancestry
AC_nfe_female	A	Integer	Alternate allele count for female samples of Non-Finnish European ancestry
AN_nfe_female	1	Integer	Total number of alleles in female samples of Non-Finnish European ancestry
AF_nfe_female	A	Float	Alternate allele frequency in female samples of Non-Finnish European ancestry
nhomalt_nfe_female	A	Integer	Count of homozygous individuals in female samples of Non-Finnish European ancestry
AC_amr	A	Integer	Alternate allele count for samples of Latino ancestry
AN_amr	1	Integer	Total number of alleles in samples of Latino ancestry
AF_amr	A	Float	Alternate allele frequency in samples of Latino ancestry
nhomalt_amr	A	Integer	Count of homozygous individuals in samples of Latino ancestry
non_topmed_AC_nfe_male	A	Integer	Alternate allele count for male samples of Non-Finnish European ancestry in the non_topmed subset
non_topmed_AN_nfe_male	1	Integer	Total number of alleles in male samples of Non-Finnish European ancestry in the non_topmed subset
non_topmed_AF_nfe_male	A	Float	Alternate allele frequency in male samples of Non-Finnish European ancestry in the non_topmed subset
non_topmed_nhomalt_nfe_male	A	Integer	Count of homozygous individuals in male samples of Non-Finnish European ancestry in the non_topmed subset
AC_eas	A	Integer	Alternate allele count for samples of East Asian ancestry
AN_eas	1	Integer	Total number of alleles in samples of East Asian ancestry
AF_eas	A	Float	Alternate allele frequency in samples of East Asian ancestry
nhomalt_eas	A	Integer	Count of homozygous individuals in samples of East Asian ancestry
nhomalt	A	Integer	Count of homozygous individuals in samples
non_neuro_AC_nfe_female	A	Integer	Alternate allele count for female samples of Non-Finnish European ancestry in the non_neuro subset
non_neuro_AN_nfe_female	1	Integer	Total number of alleles in female samples of Non-Finnish European ancestry in the non_neuro subset
non_neuro_AF_nfe_female	A	Float	Alternate allele frequency in female samples of Non-Finnish European ancestry in the non_neuro subset
non_neuro_nhomalt_nfe_female	A	Integer	Count of homozygous individuals in female samples of Non-Finnish European ancestry in the non_neuro subset
non_neuro_AC_afr	A	Integer	Alternate allele count for samples of African-American/African ancestry in the non_neuro subset
non_neuro_AN_afr	1	Integer	Total number of alleles in samples of African-American/African ancestry in the non_neuro subset
non_neuro_AF_afr	A	Float	Alternate allele frequency in samples of African-American/African ancestry in the non_neuro subset
non_neuro_nhomalt_afr	A	Integer	Count of homozygous individuals in samples of African-American/African ancestry in the non_neuro subset
controls_AC_raw	A	Integer	Alternate allele count for samples in the controls subset, before removing low-confidence genotypes
controls_AN_raw	1	Integer	Total number of alleles in samples in the controls subset, before removing low-confidence genotypes
controls_AF_raw	A	Float	Alternate allele frequency in samples in the controls subset, before removing low-confidence genotypes
controls_nhomalt_raw	A	Integer	Count of homozygous individuals in samples in the controls subset, before removing low-confidence genotypes
controls_AC_male	A	Integer	Alternate allele count for male samples in the controls subset
controls_AN_male	1	Integer	Total number of alleles in male samples in the controls subset
controls_AF_male	A	Float	Alternate allele frequency in male samples in the controls subset
controls_nhomalt_male	A	Integer	Count of homozygous individuals in male samples in the controls subset
non_topmed_AC_male	A	Integer	Alternate allele count for male samples in the non_topmed subset
non_topmed_AN_male	1	Integer	Total number of alleles in male samples in the non_topmed subset
non_topmed_AF_male	A	Float	Alternate allele frequency in male samples in the non_topmed subset
non_topmed_nhomalt_male	A	Integer	Count of homozygous individuals in male samples in the non_topmed subset
controls_AC_nfe_female	A	Integer	Alternate allele count for female samples of Non-Finnish European ancestry in the controls subset
controls_AN_nfe_female	1	Integer	Total number of alleles in female samples of Non-Finnish European ancestry in the controls subset
controls_AF_nfe_female	A	Float	Alternate allele frequency in female samples of Non-Finnish European ancestry in the controls subset
controls_nhomalt_nfe_female	A	Integer	Count of homozygous individuals in female samples of Non-Finnish European ancestry in the controls subset
non_neuro_AC_amr	A	Integer	Alternate allele count for samples of Latino ancestry in the non_neuro subset
non_neuro_AN_amr	1	Integer	Total number of alleles in samples of Latino ancestry in the non_neuro subset
non_neuro_AF_amr	A	Float	Alternate allele frequency in samples of Latino ancestry in the non_neuro subset
non_neuro_nhomalt_amr	A	Integer	Count of homozygous individuals in samples of Latino ancestry in the non_neuro subset
non_neuro_AC_eas_female	A	Integer	Alternate allele count for female samples of East Asian ancestry in the non_neuro subset
non_neuro_AN_eas_female	1	Integer	Total number of alleles in female samples of East Asian ancestry in the non_neuro subset
non_neuro_AF_eas_female	A	Float	Alternate allele frequency in female samples of East Asian ancestry in the non_neuro subset
non_neuro_nhomalt_eas_female	A	Integer	Count of homozygous individuals in female samples of East Asian ancestry in the non_neuro subset
AC_asj_male	A	Integer	Alternate allele count for male samples of Ashkenazi Jewish ancestry
AN_asj_male	1	Integer	Total number of alleles in male samples of Ashkenazi Jewish ancestry
AF_asj_male	A	Float	Alternate allele frequency in male samples of Ashkenazi Jewish ancestry
nhomalt_asj_male	A	Integer	Count of homozygous individuals in male samples of Ashkenazi Jewish ancestry
controls_AC_nfe_male	A	Integer	Alternate allele count for male samples of Non-Finnish European ancestry in the controls subset
controls_AN_nfe_male	1	Integer	Total number of alleles in male samples of Non-Finnish European ancestry in the controls subset
controls_AF_nfe_male	A	Float	Alternate allele frequency in male samples of Non-Finnish European ancestry in the controls subset
controls_nhomalt_nfe_male	A	Integer	Count of homozygous individuals in male samples of Non-Finnish European ancestry in the controls subset
non_neuro_AC_fin	A	Integer	Alternate allele count for samples of Finnish ancestry in the non_neuro subset
non_neuro_AN_fin	1	Integer	Total number of alleles in samples of Finnish ancestry in the non_neuro subset
non_neuro_AF_fin	A	Float	Alternate allele frequency in samples of Finnish ancestry in the non_neuro subset
non_neuro_nhomalt_fin	A	Integer	Count of homozygous individuals in samples of Finnish ancestry in the non_neuro subset
AC_oth_female	A	Integer	Alternate allele count for female samples of Other ancestry
AN_oth_female	1	Integer	Total number of alleles in female samples of Other ancestry
AF_oth_female	A	Float	Alternate allele frequency in female samples of Other ancestry
nhomalt_oth_female	A	Integer	Count of homozygous individuals in female samples of Other ancestry
controls_AC_nfe	A	Integer	Alternate allele count for samples of Non-Finnish European ancestry in the controls subset
controls_AN_nfe	1	Integer	Total number of alleles in samples of Non-Finnish European ancestry in the controls subset
controls_AF_nfe	A	Float	Alternate allele frequency in samples of Non-Finnish European ancestry in the controls subset
controls_nhomalt_nfe	A	Integer	Count of homozygous individuals in samples of Non-Finnish European ancestry in the controls subset
controls_AC_oth_female	A	Integer	Alternate allele count for female samples of Other ancestry in the controls subset
controls_AN_oth_female	1	Integer	Total number of alleles in female samples of Other ancestry in the controls subset
controls_AF_oth_female	A	Float	Alternate allele frequency in female samples of Other ancestry in the controls subset
controls_nhomalt_oth_female	A	Integer	Count of homozygous individuals in female samples of Other ancestry in the controls subset
controls_AC_asj	A	Integer	Alternate allele count for samples of Ashkenazi Jewish ancestry in the controls subset
controls_AN_asj	1	Integer	Total number of alleles in samples of Ashkenazi Jewish ancestry in the controls subset
controls_AF_asj	A	Float	Alternate allele frequency in samples of Ashkenazi Jewish ancestry in the controls subset
controls_nhomalt_asj	A	Integer	Count of homozygous individuals in samples of Ashkenazi Jewish ancestry in the controls subset
non_neuro_AC_amr_male	A	Integer	Alternate allele count for male samples of Latino ancestry in the non_neuro subset
non_neuro_AN_amr_male	1	Integer	Total number of alleles in male samples of Latino ancestry in the non_neuro subset
non_neuro_AF_amr_male	A	Float	Alternate allele frequency in male samples of Latino ancestry in the non_neuro subset
non_neuro_nhomalt_amr_male	A	Integer	Count of homozygous individuals in male samples of Latino ancestry in the non_neuro subset
controls_AC_nfe_nwe	A	Integer	Alternate allele count for samples of North-Western European ancestry in the controls subset
controls_AN_nfe_nwe	1	Integer	Total number of alleles in samples of North-Western European ancestry in the controls subset
controls_AF_nfe_nwe	A	Float	Alternate allele frequency in samples of North-Western European ancestry in the controls subset
controls_nhomalt_nfe_nwe	A	Integer	Count of homozygous individuals in samples of North-Western European ancestry in the controls subset
AC_nfe_nwe	A	Integer	Alternate allele count for samples of North-Western European ancestry
AN_nfe_nwe	1	Integer	Total number of alleles in samples of North-Western European ancestry
AF_nfe_nwe	A	Float	Alternate allele frequency in samples of North-Western European ancestry
nhomalt_nfe_nwe	A	Integer	Count of homozygous individuals in samples of North-Western European ancestry
controls_AC_nfe_seu	A	Integer	Alternate allele count for samples of Southern European ancestry in the controls subset
controls_AN_nfe_seu	1	Integer	Total number of alleles in samples of Southern European ancestry in the controls subset
controls_AF_nfe_seu	A	Float	Alternate allele frequency in samples of Southern European ancestry in the controls subset
controls_nhomalt_nfe_seu	A	Integer	Count of homozygous individuals in samples of Southern European ancestry in the controls subset
non_neuro_AC_amr_female	A	Integer	Alternate allele count for female samples of Latino ancestry in the non_neuro subset
non_neuro_AN_amr_female	1	Integer	Total number of alleles in female samples of Latino ancestry in the non_neuro subset
non_neuro_AF_amr_female	A	Float	Alternate allele frequency in female samples of Latino ancestry in the non_neuro subset
non_neuro_nhomalt_amr_female	A	Integer	Count of homozygous individuals in female samples of Latino ancestry in the non_neuro subset
non_neuro_AC_nfe_onf	A	Integer	Alternate allele count for samples of Other Non-Finnish European ancestry in the non_neuro subset
non_neuro_AN_nfe_onf	1	Integer	Total number of alleles in samples of Other Non-Finnish European ancestry in the non_neuro subset
non_neuro_AF_nfe_onf	A	Float	Alternate allele frequency in samples of Other Non-Finnish European ancestry in the non_neuro subset
non_neuro_nhomalt_nfe_onf	A	Integer	Count of homozygous individuals in samples of Other Non-Finnish European ancestry in the non_neuro subset
non_topmed_AC_eas_male	A	Integer	Alternate allele count for male samples of East Asian ancestry in the non_topmed subset
non_topmed_AN_eas_male	1	Integer	Total number of alleles in male samples of East Asian ancestry in the non_topmed subset
non_topmed_AF_eas_male	A	Float	Alternate allele frequency in male samples of East Asian ancestry in the non_topmed subset
non_topmed_nhomalt_eas_male	A	Integer	Count of homozygous individuals in male samples of East Asian ancestry in the non_topmed subset
controls_AC_amr_female	A	Integer	Alternate allele count for female samples of Latino ancestry in the controls subset
controls_AN_amr_female	1	Integer	Total number of alleles in female samples of Latino ancestry in the controls subset
controls_AF_amr_female	A	Float	Alternate allele frequency in female samples of Latino ancestry in the controls subset
controls_nhomalt_amr_female	A	Integer	Count of homozygous individuals in female samples of Latino ancestry in the controls subset
non_neuro_AC_fin_male	A	Integer	Alternate allele count for male samples of Finnish ancestry in the non_neuro subset
non_neuro_AN_fin_male	1	Integer	Total number of alleles in male samples of Finnish ancestry in the non_neuro subset
non_neuro_AF_fin_male	A	Float	Alternate allele frequency in male samples of Finnish ancestry in the non_neuro subset
non_neuro_nhomalt_fin_male	A	Integer	Count of homozygous individuals in male samples of Finnish ancestry in the non_neuro subset
AC_female	A	Integer	Alternate allele count for female samples
AN_female	1	Integer	Total number of alleles in female samples
AF_female	A	Float	Alternate allele frequency in female samples
nhomalt_female	A	Integer	Count of homozygous individuals in female samples
non_neuro_AC_oth_male	A	Integer	Alternate allele count for male samples of Other ancestry in the non_neuro subset
non_neuro_AN_oth_male	1	Integer	Total number of alleles in male samples of Other ancestry in the non_neuro subset
non_neuro_AF_oth_male	A	Float	Alternate allele frequency in male samples of Other ancestry in the non_neuro subset
non_neuro_nhomalt_oth_male	A	Integer	Count of homozygous individuals in male samples of Other ancestry in the non_neuro subset
non_topmed_AC_nfe_est	A	Integer	Alternate allele count for samples of Estonian ancestry in the non_topmed subset
non_topmed_AN_nfe_est	1	Integer	Total number of alleles in samples of Estonian ancestry in the non_topmed subset
non_topmed_AF_nfe_est	A	Float	Alternate allele frequency in samples of Estonian ancestry in the non_topmed subset
non_topmed_nhomalt_nfe_est	A	Integer	Count of homozygous individuals in samples of Estonian ancestry in the non_topmed subset
non_topmed_AC_nfe_nwe	A	Integer	Alternate allele count for samples of North-Western European ancestry in the non_topmed subset
non_topmed_AN_nfe_nwe	1	Integer	Total number of alleles in samples of North-Western European ancestry in the non_topmed subset
non_topmed_AF_nfe_nwe	A	Float	Alternate allele frequency in samples of North-Western European ancestry in the non_topmed subset
non_topmed_nhomalt_nfe_nwe	A	Integer	Count of homozygous individuals in samples of North-Western European ancestry in the non_topmed subset
non_topmed_AC_amr_male	A	Integer	Alternate allele count for male samples of Latino ancestry in the non_topmed subset
non_topmed_AN_amr_male	1	Integer	Total number of alleles in male samples of Latino ancestry in the non_topmed subset
non_topmed_AF_amr_male	A	Float	Alternate allele frequency in male samples of Latino ancestry in the non_topmed subset
non_topmed_nhomalt_amr_male	A	Integer	Count of homozygous individuals in male samples of Latino ancestry in the non_topmed subset
non_topmed_AC_nfe_onf	A	Integer	Alternate allele count for samples of Other Non-Finnish European ancestry in the non_topmed subset
non_topmed_AN_nfe_onf	1	Integer	Total number of alleles in samples of Other Non-Finnish European ancestry in the non_topmed subset
non_topmed_AF_nfe_onf	A	Float	Alternate allele frequency in samples of Other Non-Finnish European ancestry in the non_topmed subset
non_topmed_nhomalt_nfe_onf	A	Integer	Count of homozygous individuals in samples of Other Non-Finnish European ancestry in the non_topmed subset
controls_AC_eas_male	A	Integer	Alternate allele count for male samples of East Asian ancestry in the controls subset
controls_AN_eas_male	1	Integer	Total number of alleles in male samples of East Asian ancestry in the controls subset
controls_AF_eas_male	A	Float	Alternate allele frequency in male samples of East Asian ancestry in the controls subset
controls_nhomalt_eas_male	A	Integer	Count of homozygous individuals in male samples of East Asian ancestry in the controls subset
controls_AC_oth_male	A	Integer	Alternate allele count for male samples of Other ancestry in the controls subset
controls_AN_oth_male	1	Integer	Total number of alleles in male samples of Other ancestry in the controls subset
controls_AF_oth_male	A	Float	Alternate allele frequency in male samples of Other ancestry in the controls subset
controls_nhomalt_oth_male	A	Integer	Count of homozygous individuals in male samples of Other ancestry in the controls subset
non_topmed_AC	A	Integer	Alternate allele count for samples in the non_topmed subset
non_topmed_AN	1	Integer	Total number of alleles in samples in the non_topmed subset
non_topmed_AF	A	Float	Alternate allele frequency in samples in the non_topmed subset
non_topmed_nhomalt	A	Integer	Count of homozygous individuals in samples in the non_topmed subset
controls_AC_fin	A	Integer	Alternate allele count for samples of Finnish ancestry in the controls subset
controls_AN_fin	1	Integer	Total number of alleles in samples of Finnish ancestry in the controls subset
controls_AF_fin	A	Float	Alternate allele frequency in samples of Finnish ancestry in the controls subset
controls_nhomalt_fin	A	Integer	Count of homozygous individuals in samples of Finnish ancestry in the controls subset
non_neuro_AC_nfe	A	Integer	Alternate allele count for samples of Non-Finnish European ancestry in the non_neuro subset
non_neuro_AN_nfe	1	Integer	Total number of alleles in samples of Non-Finnish European ancestry in the non_neuro subset
non_neuro_AF_nfe	A	Float	Alternate allele frequency in samples of Non-Finnish European ancestry in the non_neuro subset
non_neuro_nhomalt_nfe	A	Integer	Count of homozygous individuals in samples of Non-Finnish European ancestry in the non_neuro subset
non_neuro_AC_fin_female	A	Integer	Alternate allele count for female samples of Finnish ancestry in the non_neuro subset
non_neuro_AN_fin_female	1	Integer	Total number of alleles in female samples of Finnish ancestry in the non_neuro subset
non_neuro_AF_fin_female	A	Float	Alternate allele frequency in female samples of Finnish ancestry in the non_neuro subset
non_neuro_nhomalt_fin_female	A	Integer	Count of homozygous individuals in female samples of Finnish ancestry in the non_neuro subset
non_topmed_AC_nfe_seu	A	Integer	Alternate allele count for samples of Southern European ancestry in the non_topmed subset
non_topmed_AN_nfe_seu	1	Integer	Total number of alleles in samples of Southern European ancestry in the non_topmed subset
non_topmed_AF_nfe_seu	A	Float	Alternate allele frequency in samples of Southern European ancestry in the non_topmed subset
non_topmed_nhomalt_nfe_seu	A	Integer	Count of homozygous individuals in samples of Southern European ancestry in the non_topmed subset
controls_AC_eas_female	A	Integer	Alternate allele count for female samples of East Asian ancestry in the controls subset
controls_AN_eas_female	1	Integer	Total number of alleles in female samples of East Asian ancestry in the controls subset
controls_AF_eas_female	A	Float	Alternate allele frequency in female samples of East Asian ancestry in the controls subset
controls_nhomalt_eas_female	A	Integer	Count of homozygous individuals in female samples of East Asian ancestry in the controls subset
non_topmed_AC_asj	A	Integer	Alternate allele count for samples of Ashkenazi Jewish ancestry in the non_topmed subset
non_topmed_AN_asj	1	Integer	Total number of alleles in samples of Ashkenazi Jewish ancestry in the non_topmed subset
non_topmed_AF_asj	A	Float	Alternate allele frequency in samples of Ashkenazi Jewish ancestry in the non_topmed subset
non_topmed_nhomalt_asj	A	Integer	Count of homozygous individuals in samples of Ashkenazi Jewish ancestry in the non_topmed subset
controls_AC_nfe_onf	A	Integer	Alternate allele count for samples of Other Non-Finnish European ancestry in the controls subset
controls_AN_nfe_onf	1	Integer	Total number of alleles in samples of Other Non-Finnish European ancestry in the controls subset
controls_AF_nfe_onf	A	Float	Alternate allele frequency in samples of Other Non-Finnish European ancestry in the controls subset
controls_nhomalt_nfe_onf	A	Integer	Count of homozygous individuals in samples of Other Non-Finnish European ancestry in the controls subset
non_neuro_AC	A	Integer	Alternate allele count for samples in the non_neuro subset
non_neuro_AN	1	Integer	Total number of alleles in samples in the non_neuro subset
non_neuro_AF	A	Float	Alternate allele frequency in samples in the non_neuro subset
non_neuro_nhomalt	A	Integer	Count of homozygous individuals in samples in the non_neuro subset
non_topmed_AC_nfe	A	Integer	Alternate allele count for samples of Non-Finnish European ancestry in the non_topmed subset
non_topmed_AN_nfe	1	Integer	Total number of alleles in samples of Non-Finnish European ancestry in the non_topmed subset
non_topmed_AF_nfe	A	Float	Alternate allele frequency in samples of Non-Finnish European ancestry in the non_topmed subset
non_topmed_nhomalt_nfe	A	Integer	Count of homozygous individuals in samples of Non-Finnish European ancestry in the non_topmed subset
non_topmed_AC_raw	A	Integer	Alternate allele count for samples in the non_topmed subset, before removing low-confidence genotypes
non_topmed_AN_raw	1	Integer	Total number of alleles in samples in the non_topmed subset, before removing low-confidence genotypes
non_topmed_AF_raw	A	Float	Alternate allele frequency in samples in the non_topmed subset, before removing low-confidence genotypes
non_topmed_nhomalt_raw	A	Integer	Count of homozygous individuals in samples in the non_topmed subset, before removing low-confidence genotypes
non_neuro_AC_nfe_est	A	Integer	Alternate allele count for samples of Estonian ancestry in the non_neuro subset
non_neuro_AN_nfe_est	1	Integer	Total number of alleles in samples of Estonian ancestry in the non_neuro subset
non_neuro_AF_nfe_est	A	Float	Alternate allele frequency in samples of Estonian ancestry in the non_neuro subset
non_neuro_nhomalt_nfe_est	A	Integer	Count of homozygous individuals in samples of Estonian ancestry in the non_neuro subset
non_topmed_AC_oth_male	A	Integer	Alternate allele count for male samples of Other ancestry in the non_topmed subset
non_topmed_AN_oth_male	1	Integer	Total number of alleles in male samples of Other ancestry in the non_topmed subset
non_topmed_AF_oth_male	A	Float	Alternate allele frequency in male samples of Other ancestry in the non_topmed subset
non_topmed_nhomalt_oth_male	A	Integer	Count of homozygous individuals in male samples of Other ancestry in the non_topmed subset
AC_nfe_est	A	Integer	Alternate allele count for samples of Estonian ancestry
AN_nfe_est	1	Integer	Total number of alleles in samples of Estonian ancestry
AF_nfe_est	A	Float	Alternate allele frequency in samples of Estonian ancestry
nhomalt_nfe_est	A	Integer	Count of homozygous individuals in samples of Estonian ancestry
non_topmed_AC_afr_male	A	Integer	Alternate allele count for male samples of African-American/African ancestry in the non_topmed subset
non_topmed_AN_afr_male	1	Integer	Total number of alleles in male samples of African-American/African ancestry in the non_topmed subset
non_topmed_AF_afr_male	A	Float	Alternate allele frequency in male samples of African-American/African ancestry in the non_topmed subset
non_topmed_nhomalt_afr_male	A	Integer	Count of homozygous individuals in male samples of African-American/African ancestry in the non_topmed subset
AC_eas_male	A	Integer	Alternate allele count for male samples of East Asian ancestry
AN_eas_male	1	Integer	Total number of alleles in male samples of East Asian ancestry
AF_eas_male	A	Float	Alternate allele frequency in male samples of East Asian ancestry
nhomalt_eas_male	A	Integer	Count of homozygous individuals in male samples of East Asian ancestry
controls_AC_eas	A	Integer	Alternate allele count for samples of East Asian ancestry in the controls subset
controls_AN_eas	1	Integer	Total number of alleles in samples of East Asian ancestry in the controls subset
controls_AF_eas	A	Float	Alternate allele frequency in samples of East Asian ancestry in the controls subset
controls_nhomalt_eas	A	Integer	Count of homozygous individuals in samples of East Asian ancestry in the controls subset
non_neuro_AC_eas_male	A	Integer	Alternate allele count for male samples of East Asian ancestry in the non_neuro subset
non_neuro_AN_eas_male	1	Integer	Total number of alleles in male samples of East Asian ancestry in the non_neuro subset
non_neuro_AF_eas_male	A	Float	Alternate allele frequency in male samples of East Asian ancestry in the non_neuro subset
non_neuro_nhomalt_eas_male	A	Integer	Count of homozygous individuals in male samples of East Asian ancestry in the non_neuro subset
non_neuro_AC_asj_male	A	Integer	Alternate allele count for male samples of Ashkenazi Jewish ancestry in the non_neuro subset
non_neuro_AN_asj_male	1	Integer	Total number of alleles in male samples of Ashkenazi Jewish ancestry in the non_neuro subset
non_neuro_AF_asj_male	A	Float	Alternate allele frequency in male samples of Ashkenazi Jewish ancestry in the non_neuro subset
non_neuro_nhomalt_asj_male	A	Integer	Count of homozygous individuals in male samples of Ashkenazi Jewish ancestry in the non_neuro subset
controls_AC_oth	A	Integer	Alternate allele count for samples of Other ancestry in the controls subset
controls_AN_oth	1	Integer	Total number of alleles in samples of Other ancestry in the controls subset
controls_AF_oth	A	Float	Alternate allele frequency in samples of Other ancestry in the controls subset
controls_nhomalt_oth	A	Integer	Count of homozygous individuals in samples of Other ancestry in the controls subset
AC_nfe	A	Integer	Alternate allele count for samples of Non-Finnish European ancestry
AN_nfe	1	Integer	Total number of alleles in samples of Non-Finnish European ancestry
AF_nfe	A	Float	Alternate allele frequency in samples of Non-Finnish European ancestry
nhomalt_nfe	A	Integer	Count of homozygous individuals in samples of Non-Finnish European ancestry
non_topmed_AC_female	A	Integer	Alternate allele count for female samples in the non_topmed subset
non_topmed_AN_female	1	Integer	Total number of alleles in female samples in the non_topmed subset
non_topmed_AF_female	A	Float	Alternate allele frequency in female samples in the non_topmed subset
non_topmed_nhomalt_female	A	Integer	Count of homozygous individuals in female samples in the non_topmed subset
non_neuro_AC_asj	A	Integer	Alternate allele count for samples of Ashkenazi Jewish ancestry in the non_neuro subset
non_neuro_AN_asj	1	Integer	Total number of alleles in samples of Ashkenazi Jewish ancestry in the non_neuro subset
non_neuro_AF_asj	A	Float	Alternate allele frequency in samples of Ashkenazi Jewish ancestry in the non_neuro subset
non_neuro_nhomalt_asj	A	Integer	Count of homozygous individuals in samples of Ashkenazi Jewish ancestry in the non_neuro subset
non_topmed_AC_eas_female	A	Integer	Alternate allele count for female samples of East Asian ancestry in the non_topmed subset
non_topmed_AN_eas_female	1	Integer	Total number of alleles in female samples of East Asian ancestry in the non_topmed subset
non_topmed_AF_eas_female	A	Float	Alternate allele frequency in female samples of East Asian ancestry in the non_topmed subset
non_topmed_nhomalt_eas_female	A	Integer	Count of homozygous individuals in female samples of East Asian ancestry in the non_topmed subset
non_neuro_AC_raw	A	Integer	Alternate allele count for samples in the non_neuro subset, before removing low-confidence genotypes
non_neuro_AN_raw	1	Integer	Total number of alleles in samples in the non_neuro subset, before removing low-confidence genotypes
non_neuro_AF_raw	A	Float	Alternate allele frequency in samples in the non_neuro subset, before removing low-confidence genotypes
non_neuro_nhomalt_raw	A	Integer	Count of homozygous individuals in samples in the non_neuro subset, before removing low-confidence genotypes
non_topmed_AC_eas	A	Integer	Alternate allele count for samples of East Asian ancestry in the non_topmed subset
non_topmed_AN_eas	1	Integer	Total number of alleles in samples of East Asian ancestry in the non_topmed subset
non_topmed_AF_eas	A	Float	Alternate allele frequency in samples of East Asian ancestry in the non_topmed subset
non_topmed_nhomalt_eas	A	Integer	Count of homozygous individuals in samples of East Asian ancestry in the non_topmed subset
non_topmed_AC_fin_male	A	Integer	Alternate allele count for male samples of Finnish ancestry in the non_topmed subset
non_topmed_AN_fin_male	1	Integer	Total number of alleles in male samples of Finnish ancestry in the non_topmed subset
non_topmed_AF_fin_male	A	Float	Alternate allele frequency in male samples of Finnish ancestry in the non_topmed subset
non_topmed_nhomalt_fin_male	A	Integer	Count of homozygous individuals in male samples of Finnish ancestry in the non_topmed subset
AC_fin	A	Integer	Alternate allele count for samples of Finnish ancestry
AN_fin	1	Integer	Total number of alleles in samples of Finnish ancestry
AF_fin	A	Float	Alternate allele frequency in samples of Finnish ancestry
nhomalt_fin	A	Integer	Count of homozygous individuals in samples of Finnish ancestry
AC_nfe_male	A	Integer	Alternate allele count for male samples of Non-Finnish European ancestry
AN_nfe_male	1	Integer	Total number of alleles in male samples of Non-Finnish European ancestry
AF_nfe_male	A	Float	Alternate allele frequency in male samples of Non-Finnish European ancestry
nhomalt_nfe_male	A	Integer	Count of homozygous individuals in male samples of Non-Finnish European ancestry
controls_AC_amr_male	A	Integer	Alternate allele count for male samples of Latino ancestry in the controls subset
controls_AN_amr_male	1	Integer	Total number of alleles in male samples of Latino ancestry in the controls subset
controls_AF_amr_male	A	Float	Alternate allele frequency in male samples of Latino ancestry in the controls subset
controls_nhomalt_amr_male	A	Integer	Count of homozygous individuals in male samples of Latino ancestry in the controls subset
controls_AC_afr_female	A	Integer	Alternate allele count for female samples of African-American/African ancestry in the controls subset
controls_AN_afr_female	1	Integer	Total number of alleles in female samples of African-American/African ancestry in the controls subset
controls_AF_afr_female	A	Float	Alternate allele frequency in female samples of African-American/African ancestry in the controls subset
controls_nhomalt_afr_female	A	Integer	Count of homozygous individuals in female samples of African-American/African ancestry in the controls subset
controls_AC_amr	A	Integer	Alternate allele count for samples of Latino ancestry in the controls subset
controls_AN_amr	1	Integer	Total number of alleles in samples of Latino ancestry in the controls subset
controls_AF_amr	A	Float	Alternate allele frequency in samples of Latino ancestry in the controls subset
controls_nhomalt_amr	A	Integer	Count of homozygous individuals in samples of Latino ancestry in the controls subset
AC_asj_female	A	Integer	Alternate allele count for female samples of Ashkenazi Jewish ancestry
AN_asj_female	1	Integer	Total number of alleles in female samples of Ashkenazi Jewish ancestry
AF_asj_female	A	Float	Alternate allele frequency in female samples of Ashkenazi Jewish ancestry
nhomalt_asj_female	A	Integer	Count of homozygous individuals in female samples of Ashkenazi Jewish ancestry
non_neuro_AC_eas	A	Integer	Alternate allele count for samples of East Asian ancestry in the non_neuro subset
non_neuro_AN_eas	1	Integer	Total number of alleles in samples of East Asian ancestry in the non_neuro subset
non_neuro_AF_eas	A	Float	Alternate allele frequency in samples of East Asian ancestry in the non_neuro subset
non_neuro_nhomalt_eas	A	Integer	Count of homozygous individuals in samples of East Asian ancestry in the non_neuro subset
non_neuro_AC_male	A	Integer	Alternate allele count for male samples in the non_neuro subset
non_neuro_AN_male	1	Integer	Total number of alleles in male samples in the non_neuro subset
non_neuro_AF_male	A	Float	Alternate allele frequency in male samples in the non_neuro subset
non_neuro_nhomalt_male	A	Integer	Count of homozygous individuals in male samples in the non_neuro subset
AC_asj	A	Integer	Alternate allele count for samples of Ashkenazi Jewish ancestry
AN_asj	1	Integer	Total number of alleles in samples of Ashkenazi Jewish ancestry
AF_asj	A	Float	Alternate allele frequency in samples of Ashkenazi Jewish ancestry
nhomalt_asj	A	Integer	Count of homozygous individuals in samples of Ashkenazi Jewish ancestry
controls_AC_nfe_est	A	Integer	Alternate allele count for samples of Estonian ancestry in the controls subset
controls_AN_nfe_est	1	Integer	Total number of alleles in samples of Estonian ancestry in the controls subset
controls_AF_nfe_est	A	Float	Alternate allele frequency in samples of Estonian ancestry in the controls subset
controls_nhomalt_nfe_est	A	Integer	Count of homozygous individuals in samples of Estonian ancestry in the controls subset
non_topmed_AC_asj_female	A	Integer	Alternate allele count for female samples of Ashkenazi Jewish ancestry in the non_topmed subset
non_topmed_AN_asj_female	1	Integer	Total number of alleles in female samples of Ashkenazi Jewish ancestry in the non_topmed subset
non_topmed_AF_asj_female	A	Float	Alternate allele frequency in female samples of Ashkenazi Jewish ancestry in the non_topmed subset
non_topmed_nhomalt_asj_female	A	Integer	Count of homozygous individuals in female samples of Ashkenazi Jewish ancestry in the non_topmed subset
non_topmed_AC_oth	A	Integer	Alternate allele count for samples of Other ancestry in the non_topmed subset
non_topmed_AN_oth	1	Integer	Total number of alleles in samples of Other ancestry in the non_topmed subset
non_topmed_AF_oth	A	Float	Alternate allele frequency in samples of Other ancestry in the non_topmed subset
non_topmed_nhomalt_oth	A	Integer	Count of homozygous individuals in samples of Other ancestry in the non_topmed subset
non_topmed_AC_fin_female	A	Integer	Alternate allele count for female samples of Finnish ancestry in the non_topmed subset
non_topmed_AN_fin_female	1	Integer	Total number of alleles in female samples of Finnish ancestry in the non_topmed subset
non_topmed_AF_fin_female	A	Float	Alternate allele frequency in female samples of Finnish ancestry in the non_topmed subset
non_topmed_nhomalt_fin_female	A	Integer	Count of homozygous individuals in female samples of Finnish ancestry in the non_topmed subset
AC_oth	A	Integer	Alternate allele count for samples of Other ancestry
AN_oth	1	Integer	Total number of alleles in samples of Other ancestry
AF_oth	A	Float	Alternate allele frequency in samples of Other ancestry
nhomalt_oth	A	Integer	Count of homozygous individuals in samples of Other ancestry
non_neuro_AC_nfe_male	A	Integer	Alternate allele count for male samples of Non-Finnish European ancestry in the non_neuro subset
non_neuro_AN_nfe_male	1	Integer	Total number of alleles in male samples of Non-Finnish European ancestry in the non_neuro subset
non_neuro_AF_nfe_male	A	Float	Alternate allele frequency in male samples of Non-Finnish European ancestry in the non_neuro subset
non_neuro_nhomalt_nfe_male	A	Integer	Count of homozygous individuals in male samples of Non-Finnish European ancestry in the non_neuro subset
controls_AC_female	A	Integer	Alternate allele count for female samples in the controls subset
controls_AN_female	1	Integer	Total number of alleles in female samples in the controls subset
controls_AF_female	A	Float	Alternate allele frequency in female samples in the controls subset
controls_nhomalt_female	A	Integer	Count of homozygous individuals in female samples in the controls subset
non_topmed_AC_fin	A	Integer	Alternate allele count for samples of Finnish ancestry in the non_topmed subset
non_topmed_AN_fin	1	Integer	Total number of alleles in samples of Finnish ancestry in the non_topmed subset
non_topmed_AF_fin	A	Float	Alternate allele frequency in samples of Finnish ancestry in the non_topmed subset
non_topmed_nhomalt_fin	A	Integer	Count of homozygous individuals in samples of Finnish ancestry in the non_topmed subset
non_topmed_AC_nfe_female	A	Integer	Alternate allele count for female samples of Non-Finnish European ancestry in the non_topmed subset
non_topmed_AN_nfe_female	1	Integer	Total number of alleles in female samples of Non-Finnish European ancestry in the non_topmed subset
non_topmed_AF_nfe_female	A	Float	Alternate allele frequency in female samples of Non-Finnish European ancestry in the non_topmed subset
non_topmed_nhomalt_nfe_female	A	Integer	Count of homozygous individuals in female samples of Non-Finnish European ancestry in the non_topmed subset
controls_AC_asj_male	A	Integer	Alternate allele count for male samples of Ashkenazi Jewish ancestry in the controls subset
controls_AN_asj_male	1	Integer	Total number of alleles in male samples of Ashkenazi Jewish ancestry in the controls subset
controls_AF_asj_male	A	Float	Alternate allele frequency in male samples of Ashkenazi Jewish ancestry in the controls subset
controls_nhomalt_asj_male	A	Integer	Count of homozygous individuals in male samples of Ashkenazi Jewish ancestry in the controls subset
non_topmed_AC_asj_male	A	Integer	Alternate allele count for male samples of Ashkenazi Jewish ancestry in the non_topmed subset
non_topmed_AN_asj_male	1	Integer	Total number of alleles in male samples of Ashkenazi Jewish ancestry in the non_topmed subset
non_topmed_AF_asj_male	A	Float	Alternate allele frequency in male samples of Ashkenazi Jewish ancestry in the non_topmed subset
non_topmed_nhomalt_asj_male	A	Integer	Count of homozygous individuals in male samples of Ashkenazi Jewish ancestry in the non_topmed subset
non_neuro_AC_oth	A	Integer	Alternate allele count for samples of Other ancestry in the non_neuro subset
non_neuro_AN_oth	1	Integer	Total number of alleles in samples of Other ancestry in the non_neuro subset
non_neuro_AF_oth	A	Float	Alternate allele frequency in samples of Other ancestry in the non_neuro subset
non_neuro_nhomalt_oth	A	Integer	Count of homozygous individuals in samples of Other ancestry in the non_neuro subset
AC_male	A	Integer	Alternate allele count for male samples
AN_male	1	Integer	Total number of alleles in male samples
AF_male	A	Float	Alternate allele frequency in male samples
nhomalt_male	A	Integer	Count of homozygous individuals in male samples
controls_AC_fin_female	A	Integer	Alternate allele count for female samples of Finnish ancestry in the controls subset
controls_AN_fin_female	1	Integer	Total number of alleles in female samples of Finnish ancestry in the controls subset
controls_AF_fin_female	A	Float	Alternate allele frequency in female samples of Finnish ancestry in the controls subset
controls_nhomalt_fin_female	A	Integer	Count of homozygous individuals in female samples of Finnish ancestry in the controls subset
controls_AC_asj_female	A	Integer	Alternate allele count for female samples of Ashkenazi Jewish ancestry in the controls subset
controls_AN_asj_female	1	Integer	Total number of alleles in female samples of Ashkenazi Jewish ancestry in the controls subset
controls_AF_asj_female	A	Float	Alternate allele frequency in female samples of Ashkenazi Jewish ancestry in the controls subset
controls_nhomalt_asj_female	A	Integer	Count of homozygous individuals in female samples of Ashkenazi Jewish ancestry in the controls subset
AC_amr_male	A	Integer	Alternate allele count for male samples of Latino ancestry
AN_amr_male	1	Integer	Total number of alleles in male samples of Latino ancestry
AF_amr_male	A	Float	Alternate allele frequency in male samples of Latino ancestry
nhomalt_amr_male	A	Integer	Count of homozygous individuals in male samples of Latino ancestry
AC_amr_female	A	Integer	Alternate allele count for female samples of Latino ancestry
AN_amr_female	1	Integer	Total number of alleles in female samples of Latino ancestry
AF_amr_female	A	Float	Alternate allele frequency in female samples of Latino ancestry
nhomalt_amr_female	A	Integer	Count of homozygous individuals in female samples of Latino ancestry
AC_oth_male	A	Integer	Alternate allele count for male samples of Other ancestry
AN_oth_male	1	Integer	Total number of alleles in male samples of Other ancestry
AF_oth_male	A	Float	Alternate allele frequency in male samples of Other ancestry
nhomalt_oth_male	A	Integer	Count of homozygous individuals in male samples of Other ancestry
non_neuro_AC_nfe_seu	A	Integer	Alternate allele count for samples of Southern European ancestry in the non_neuro subset
non_neuro_AN_nfe_seu	1	Integer	Total number of alleles in samples of Southern European ancestry in the non_neuro subset
non_neuro_AF_nfe_seu	A	Float	Alternate allele frequency in samples of Southern European ancestry in the non_neuro subset
non_neuro_nhomalt_nfe_seu	A	Integer	Count of homozygous individuals in samples of Southern European ancestry in the non_neuro subset
non_topmed_AC_afr_female	A	Integer	Alternate allele count for female samples of African-American/African ancestry in the non_topmed subset
non_topmed_AN_afr_female	1	Integer	Total number of alleles in female samples of African-American/African ancestry in the non_topmed subset
non_topmed_AF_afr_female	A	Float	Alternate allele frequency in female samples of African-American/African ancestry in the non_topmed subset
non_topmed_nhomalt_afr_female	A	Integer	Count of homozygous individuals in female samples of African-American/African ancestry in the non_topmed subset
non_topmed_AC_afr	A	Integer	Alternate allele count for samples of African-American/African ancestry in the non_topmed subset
non_topmed_AN_afr	1	Integer	Total number of alleles in samples of African-American/African ancestry in the non_topmed subset
non_topmed_AF_afr	A	Float	Alternate allele frequency in samples of African-American/African ancestry in the non_topmed subset
non_topmed_nhomalt_afr	A	Integer	Count of homozygous individuals in samples of African-American/African ancestry in the non_topmed subset
controls_AC	A	Integer	Alternate allele count for samples in the controls subset
controls_AN	1	Integer	Total number of alleles in samples in the controls subset
controls_AF	A	Float	Alternate allele frequency in samples in the controls subset
controls_nhomalt	A	Integer	Count of homozygous individuals in samples in the controls subset
non_neuro_AC_oth_female	A	Integer	Alternate allele count for female samples of Other ancestry in the non_neuro subset
non_neuro_AN_oth_female	1	Integer	Total number of alleles in female samples of Other ancestry in the non_neuro subset
non_neuro_AF_oth_female	A	Float	Alternate allele frequency in female samples of Other ancestry in the non_neuro subset
non_neuro_nhomalt_oth_female	A	Integer	Count of homozygous individuals in female samples of Other ancestry in the non_neuro subset
non_topmed_faf95_amr	A	Float	Filtering allele frequency (using Poisson 95% CI) for samples of Latino ancestry in the non_topmed subset
non_topmed_faf99_amr	A	Float	Filtering allele frequency (using Poisson 99% CI) for samples of Latino ancestry in the non_topmed subset
faf95_afr	A	Float	Filtering allele frequency (using Poisson 95% CI) for samples of African-American/African ancestry
faf99_afr	A	Float	Filtering allele frequency (using Poisson 99% CI) for samples of African-American/African ancestry
controls_faf95_afr	A	Float	Filtering allele frequency (using Poisson 95% CI) for samples of African-American/African ancestry in the controls subset
controls_faf99_afr	A	Float	Filtering allele frequency (using Poisson 99% CI) for samples of African-American/African ancestry in the controls subset
faf95_amr	A	Float	Filtering allele frequency (using Poisson 95% CI) for samples of Latino ancestry
faf99_amr	A	Float	Filtering allele frequency (using Poisson 99% CI) for samples of Latino ancestry
faf95_eas	A	Float	Filtering allele frequency (using Poisson 95% CI) for samples of East Asian ancestry
faf99_eas	A	Float	Filtering allele frequency (using Poisson 99% CI) for samples of East Asian ancestry
faf95	A	Float	Filtering allele frequency (using Poisson 95% CI) for samples
faf99	A	Float	Filtering allele frequency (using Poisson 99% CI) for samples
non_neuro_faf95_afr	A	Float	Filtering allele frequency (using Poisson 95% CI) for samples of African-American/African ancestry in the non_neuro subset
non_neuro_faf99_afr	A	Float	Filtering allele frequency (using Poisson 99% CI) for samples of African-American/African ancestry in the non_neuro subset
non_neuro_faf95_amr	A	Float	Filtering allele frequency (using Poisson 95% CI) for samples of Latino ancestry in the non_neuro subset
non_neuro_faf99_amr	A	Float	Filtering allele frequency (using Poisson 99% CI) for samples of Latino ancestry in the non_neuro subset
controls_faf95_nfe	A	Float	Filtering allele frequency (using Poisson 95% CI) for samples of Non-Finnish European ancestry in the controls subset
controls_faf99_nfe	A	Float	Filtering allele frequency (using Poisson 99% CI) for samples of Non-Finnish European ancestry in the controls subset
non_topmed_faf95	A	Float	Filtering allele frequency (using Poisson 95% CI) for samples in the non_topmed subset
non_topmed_faf99	A	Float	Filtering allele frequency (using Poisson 99% CI) for samples in the non_topmed subset
non_neuro_faf95_nfe	A	Float	Filtering allele frequency (using Poisson 95% CI) for samples of Non-Finnish European ancestry in the non_neuro subset
non_neuro_faf99_nfe	A	Float	Filtering allele frequency (using Poisson 99% CI) for samples of Non-Finnish European ancestry in the non_neuro subset
non_neuro_faf95	A	Float	Filtering allele frequency (using Poisson 95% CI) for samples in the non_neuro subset
non_neuro_faf99	A	Float	Filtering allele frequency (using Poisson 99% CI) for samples in the non_neuro subset
non_topmed_faf95_nfe	A	Float	Filtering allele frequency (using Poisson 95% CI) for samples of Non-Finnish European ancestry in the non_topmed subset
non_topmed_faf99_nfe	A	Float	Filtering allele frequency (using Poisson 99% CI) for samples of Non-Finnish European ancestry in the non_topmed subset
controls_faf95_eas	A	Float	Filtering allele frequency (using Poisson 95% CI) for samples of East Asian ancestry in the controls subset
controls_faf99_eas	A	Float	Filtering allele frequency (using Poisson 99% CI) for samples of East Asian ancestry in the controls subset
faf95_nfe	A	Float	Filtering allele frequency (using Poisson 95% CI) for samples of Non-Finnish European ancestry
faf99_nfe	A	Float	Filtering allele frequency (using Poisson 99% CI) for samples of Non-Finnish European ancestry
non_topmed_faf95_eas	A	Float	Filtering allele frequency (using Poisson 95% CI) for samples of East Asian ancestry in the non_topmed subset
non_topmed_faf99_eas	A	Float	Filtering allele frequency (using Poisson 99% CI) for samples of East Asian ancestry in the non_topmed subset
controls_faf95_amr	A	Float	Filtering allele frequency (using Poisson 95% CI) for samples of Latino ancestry in the controls subset
controls_faf99_amr	A	Float	Filtering allele frequency (using Poisson 99% CI) for samples of Latino ancestry in the controls subset
non_neuro_faf95_eas	A	Float	Filtering allele frequency (using Poisson 95% CI) for samples of East Asian ancestry in the non_neuro subset
non_neuro_faf99_eas	A	Float	Filtering allele frequency (using Poisson 99% CI) for samples of East Asian ancestry in the non_neuro subset
non_topmed_faf95_afr	A	Float	Filtering allele frequency (using Poisson 95% CI) for samples of African-American/African ancestry in the non_topmed subset
non_topmed_faf99_afr	A	Float	Filtering allele frequency (using Poisson 99% CI) for samples of African-American/African ancestry in the non_topmed subset
controls_faf95	A	Float	Filtering allele frequency (using Poisson 95% CI) for samples in the controls subset
controls_faf99	A	Float	Filtering allele frequency (using Poisson 99% CI) for samples in the controls subset
controls_popmax	A	String	Population with maximum AF in the controls subset
controls_AC_popmax	A	Integer	Allele count in the population with the maximum AF in the controls subset
controls_AN_popmax	A	Integer	Total number of alleles in the population with the maximum AF in the controls subset
controls_AF_popmax	A	Float	Maximum allele frequency across populations (excluding samples of Ashkenazi, Finnish, and indeterminate ancestry) in the controls subset
controls_nhomalt_popmax	A	Integer	Count of homozygous individuals in the population with the maximum allele frequency in the controls subset
popmax	A	String	Population with maximum AF
AC_popmax	A	Integer	Allele count in the population with the maximum AF
AN_popmax	A	Integer	Total number of alleles in the population with the maximum AF
AF_popmax	A	Float	Maximum allele frequency across populations (excluding samples of Ashkenazi, Finnish, and indeterminate ancestry)
nhomalt_popmax	A	Integer	Count of homozygous individuals in the population with the maximum allele frequency
age_hist_het_bin_freq	A	String	Histogram of ages of heterozygous individuals; bin edges are: 30.0|35.0|40.0|45.0|50.0|55.0|60.0|65.0|70.0|75.0|80.0; total number of individuals of any genotype bin: 2522|623|663|923|1363|1666|1254|1001|640|362|154|70
age_hist_het_n_smaller	A	Integer	Count of age values falling below lowest histogram bin edge for heterozygous individuals
age_hist_het_n_larger	A	Integer	Count of age values falling above highest histogram bin edge for heterozygous individuals
age_hist_hom_bin_freq	A	String	Histogram of ages of homozygous alternate individuals; bin edges are: 30.0|35.0|40.0|45.0|50.0|55.0|60.0|65.0|70.0|75.0|80.0; total number of individuals of any genotype bin: 2522|623|663|923|1363|1666|1254|1001|640|362|154|70
age_hist_hom_n_smaller	A	Integer	Count of age values falling below lowest histogram bin edge for homozygous alternate individuals
age_hist_hom_n_larger	A	Integer	Count of age values falling above highest histogram bin edge for homozygous alternate individuals
non_neuro_popmax	A	String	Population with maximum AF in the non_neuro subset
non_neuro_AC_popmax	A	Integer	Allele count in the population with the maximum AF in the non_neuro subset
non_neuro_AN_popmax	A	Integer	Total number of alleles in the population with the maximum AF in the non_neuro subset
non_neuro_AF_popmax	A	Float	Maximum allele frequency across populations (excluding samples of Ashkenazi, Finnish, and indeterminate ancestry) in the non_neuro subset
non_neuro_nhomalt_popmax	A	Integer	Count of homozygous individuals in the population with the maximum allele frequency in the non_neuro subset
non_topmed_popmax	A	String	Population with maximum AF in the non_topmed subset
non_topmed_AC_popmax	A	Integer	Allele count in the population with the maximum AF in the non_topmed subset
non_topmed_AN_popmax	A	Integer	Total number of alleles in the population with the maximum AF in the non_topmed subset
non_topmed_AF_popmax	A	Float	Maximum allele frequency across populations (excluding samples of Ashkenazi, Finnish, and indeterminate ancestry) in the non_topmed subset
non_topmed_nhomalt_popmax	A	Integer	Count of homozygous individuals in the population with the maximum allele frequency in the non_topmed subset
vep	.	String	Consequence annotations from Ensembl VEP. Format: Allele|Consequence|IMPACT|SYMBOL|Gene|Feature_type|Feature|BIOTYPE|EXON|INTRON|HGVSc|HGVSp|cDNA_position|CDS_position|Protein_position|Amino_acids|Codons|Existing_variation|ALLELE_NUM|DISTANCE|STRAND|FLAGS|VARIANT_CLASS|MINIMISED|SYMBOL_SOURCE|HGNC_ID|CANONICAL|TSL|APPRIS|CCDS|ENSP|SWISSPROT|TREMBL|UNIPARC|GENE_PHENO|SIFT|PolyPhen|DOMAINS|HGVS_OFFSET|GMAF|AFR_MAF|AMR_MAF|EAS_MAF|EUR_MAF|SAS_MAF|AA_MAF|EA_MAF|ExAC_MAF|ExAC_Adj_MAF|ExAC_AFR_MAF|ExAC_AMR_MAF|ExAC_EAS_MAF|ExAC_FIN_MAF|ExAC_NFE_MAF|ExAC_OTH_MAF|ExAC_SAS_MAF|CLIN_SIG|SOMATIC|PHENO|PUBMED|MOTIF_NAME|MOTIF_POS|HIGH_INF_POS|MOTIF_SCORE_CHANGE|LoF|LoF_filter|LoF_flags|LoF_info
